####################
#  ...............T#
#  ...............T#
#  ....R..........T#
#  ....R..........T#
#  ....R..@.......T#
#  ....R..........T#
#  ................#
#                  #
####################
