####################
#                  #
#      DEMO-0      #
#                  #
#        .         #
#     #            #
#                  #
#                  #
#                  #
####################
