#                  #          #                  #
#..................#..................#..................#
#..................#..................#..................#
#..................#..................#..................#
#..................#..................#..................#
#..................#..................#..................#
#..................#..................#..................#
#..................#..................#..................#
#..................#..................#..................#
#..................#..................#..................#
#..................#..................#..................#
#..................#..................#..................#
#..................#..................#..................#
#..................#..................#..................#
#..................#..................#..................#
#..................#..................#..................#
#..................#..................#..................#
#..................#..................#..................#
#..................#..................#..................#
##################################################
