####################
#                  #
#      DEMO-0      #
#                  #
#        @         #
#    ##            #
#    #             #
#                  #
#       #          #
####################
