##########
#        #
#        #
#        #
#   @    #
#        #
#        #
#        #
#        #
##########