##########
#        #
#  .@    #
#  .     #
#  .@    #
#  .     #
#  .     #
#        #
#        #
##########
