####################
#                  #
#                  #
#    .             #
#                  #
#   ..#    R       #
#        .         #
#                  #
#                  #
####################
