####################
#..................#
#..................#
#..................#
#.......<..........#
#..................#
#..................#
#..................#
#..................#
####################
