p . . . . . . . 
. . . . . . . . 
. . . . . . . . 
. . . X . . X . 
. . . . . . p . 
. . . p . . . . 
. . . . . . . . 
. . . . . . . . 
