####################
#                  #
#                  #
# TEMPLATE PROJECT #
#                  #
#    R  #          #
#                  #
#                  #
#                  #
####################
