####################
#                  #
#      DEMO-0      #
#                  #
#        @         #
#    .#   #        #
#    .   #         #
#                  #
#       #          #
####################
