####################
#..................#
#..................#
#..................#
#.......>..........#
#..................#
#..................#
#..................#
#..................#
####################
