. . . . X . . . 
. . X . . . . . 
. . X X . . p . 
. . . . . . . . 
. . . . . . . . 
. . . X . . . . 
. . . . X . . . 
. . . . . . . . 
