# # # # # # # # # # # # # # # # # # # # 
# # # # # # # # # # # # # # # # # # # # 
# # # # # # # # # # # # # # # # # # # # 
# # # # # # # # # # # # # # # # # # # # 
# # # # # # # # # # # # # # # # # # # # 
# # # # # . . . . . . . . . . # # # # # 
# # # # # . . . . . . . . . . # # # # # 
# # # # # . . . . . . . . . . # # # # # 
# # # # # . . . . . @ . . . . # # # # # 
# # # # # . . . . . . . . . . # # # # # 
# # # # # . . . . . . . . . . # # # # # 
# # # # # . . . . . . . . . . # # # # # 
# # # # # . . . . . . . . . . # # # # # 
# # # # # . . . . . . . . . . # # # # # 
# # # # # . . . . . . . . . . # # # # # 
# # # # # # # # # # # # # # # # # # # # 
# # # # # # # # # # # # # # # # # # # # 
# # # # # # # # # # # # # # # # # # # # 
# # # # # # # # # # # # # # # # # # # # 
# # # # # # # # # # # # # # # # # # # # 
