####################
#..................#
#..................#
#..................#
#.......&..........#
#..................#
#..................#
#.........T........#
#..................#
####################
