####################
#                  #
#                  #
#                  #
#                  #
#    X#    R       #
#        .         #
#                  #
#                  #
####################
