####################
#                  #
#      DEMO-0      #
#                  #
#        .         #
#     #            #
#  .    .#         #
#      .           #
#                  #
####################
