####################
#                  #
#      DEMO-0      #
#                  #
#        @         #
#    ##   #        #
#    .             #
#                  #
#       #          #
####################
