####################
#                  #
#      DEMO-0      #
#                  #
#        @         #
#    ..   #        #
#    .   #         #
#  #               #
#       #          #
####################
